Doctrine and Covenants 1	1–7, The voice of warning is to all people; 8–16, Apostasy and wickedness precede the Second Coming; 17–23, Joseph Smith is called to restore to earth the Lord’s truths and powers; 24–33, The Book of Mormon is brought forth and the true Church is established; 34–36, Peace will be taken from the earth; 37–39, Search these commandments.
Doctrine and Covenants 2	1, Elijah is to reveal the priesthood; 2–3, The promises of the fathers are planted in the hearts of the children.
Doctrine and Covenants 3	1–4, The Lord’s course is one eternal round; 5–15, Joseph Smith must repent or lose the gift to translate; 16–20, The Book of Mormon comes forth to save the seed of Lehi.
Doctrine and Covenants 4	1–4, Valiant service saves the Lord’s ministers; 5–6, Godly attributes qualify them for the ministry; 7, The things of God must be sought after.
Doctrine and Covenants 5	1–10, This generation will receive the Lord’s word through Joseph Smith; 11–18, Three witnesses will testify of the Book of Mormon; 19–20, The word of the Lord will be verified as in previous times; 21–35, Martin Harris may repent and be one of the witnesses.
Doctrine and Covenants 6	1–6, Laborers in the Lord’s field gain salvation; 7–13, There is no gift greater than the gift of salvation; 14–27, A witness of the truth comes by the power of the Spirit; 28–37, Look unto Christ, and do good continually.
Doctrine and Covenants 7	1–3, John the Beloved will live until the Lord comes; 4–8, Peter, James, and John hold gospel keys.
Doctrine and Covenants 8	1–5, Revelation comes by the power of the Holy Ghost; 6–12, Knowledge of the mysteries of God and the power to translate ancient records come by faith.
Doctrine and Covenants 9	1–6, Other ancient records are yet to be translated; 7–14, The Book of Mormon is translated by study and by spiritual confirmation.
Doctrine and Covenants 10	1–26, Satan stirs up wicked men to oppose the Lord’s work; 27–33, He seeks to destroy the souls of men; 34–52, The gospel is to go to the Lamanites and all nations through the Book of Mormon; 53–63, The Lord will establish His Church and His gospel among men; 64–70, He will gather the repentant into His Church and will save the obedient.
Doctrine and Covenants 11	1–6, Laborers in the vineyard will gain salvation; 7–14, Seek wisdom, cry repentance, trust in the Spirit; 15–22, Keep the commandments, and study the Lord’s word; 23–27, Deny not the spirit of revelation and of prophecy; 28–30, Those who receive Christ become the sons of God.
Doctrine and Covenants 12	1–6, Laborers in the vineyard are to gain salvation; 7–9, All who desire and are qualified may assist in the Lord’s work.
Doctrine and Covenants 13	The keys and powers of the Aaronic Priesthood are set forth.
Doctrine and Covenants 14	1–6, Laborers in the vineyard will gain salvation; 7–8, Eternal life is the greatest of God’s gifts; 9–11, Christ created the heavens and the earth.
Doctrine and Covenants 15	1–2, The Lord’s arm is over all the earth; 3–6, To preach the gospel and save souls is the thing of most worth.
Doctrine and Covenants 16	1–2, The Lord’s arm is over all the earth; 3–6, To preach the gospel and save souls is the thing of most worth.
Doctrine and Covenants 17	1–4, By faith the Three Witnesses will see the plates and other sacred items; 5–9, Christ bears testimony of the divinity of the Book of Mormon.
Doctrine and Covenants 18	1–5, Scriptures show how to build up the Church; 6–8, The world is ripening in iniquity; 9–16, The worth of souls is great; 17–25, To gain salvation, men must take upon themselves the name of Christ; 26–36, The calling and mission of the Twelve are revealed; 37–39, Oliver Cowdery and David Whitmer are to search out the Twelve; 40–47, To gain salvation, men must repent, be baptized, and keep the commandments.
Doctrine and Covenants 19	1–3, Christ has all power; 4–5, All men must repent or suffer; 6–12, Eternal punishment is God’s punishment; 13–20, Christ suffered for all, that they might not suffer if they would repent; 21–28, Preach the gospel of repentance; 29–41, Declare glad tidings.
Doctrine and Covenants 20	1–16, The Book of Mormon proves the divinity of the latter-day work; 17–28, The doctrines of creation, fall, atonement, and baptism are affirmed; 29–37, Laws governing repentance, justification, sanctification, and baptism are set forth; 38–67, Duties of elders, priests, teachers, and deacons are summarized; 68–74, Duties of members, blessing of children, and the mode of baptism are revealed; 75–84, Sacramental prayers and regulations governing Church membership are given.
Doctrine and Covenants 21	1–3, Joseph Smith is called to be a seer, translator, prophet, apostle, and elder; 4–8, His word will guide the cause of Zion; 9–12, The Saints will believe his words as he speaks by the Comforter.
Doctrine and Covenants 22	1, Baptism is a new and everlasting covenant; 2–4, Authoritative baptism is required.
Doctrine and Covenants 23	1–7, These early disciples are called to preach, exhort, and strengthen the Church.
Doctrine and Covenants 24	1–9, Joseph Smith is called to translate, preach, and expound scriptures; 10–12, Oliver Cowdery is called to preach the gospel; 13–19, The law is revealed relative to miracles, cursings, casting off the dust of one’s feet, and going without purse or scrip.
Doctrine and Covenants 25	1–6, Emma Smith, an elect lady, is called to aid and comfort her husband; 7–11, She is also called to write, to expound scriptures, and to select hymns; 12–14, The song of the righteous is a prayer unto the Lord; 15–16, Principles of obedience in this revelation are applicable to all.
Doctrine and Covenants 26	1, They are instructed to study the scriptures and to preach; 2, The law of common consent is affirmed.
Doctrine and Covenants 27	1–4, The emblems to be used in partaking of the sacrament are set forth; 5–14, Christ and His servants from all dispensations are to partake of the sacrament; 15–18, Put on the whole armor of God.
Doctrine and Covenants 28	1–7, Joseph Smith holds the keys of the mysteries, and only he receives revelations for the Church; 8–10, Oliver Cowdery is to preach to the Lamanites; 11–16, Satan deceived Hiram Page and gave him false revelations.
Doctrine and Covenants 29	1–8, Christ gathers His elect; 9–11, His coming ushers in the Millennium; 12–13, The Twelve will judge all Israel; 14–21, Signs, plagues, and desolations will precede the Second Coming; 22–28, The last resurrection and final judgment follow the Millennium; 29–35, All things are spiritual unto the Lord; 36–39, The devil and his hosts were cast out of heaven to tempt man; 40–45, The Fall and Atonement bring salvation; 46–50, Little children are redeemed through the Atonement.
Doctrine and Covenants 30	1–4, David Whitmer is chastened for failure to serve diligently; 5–8, Peter Whitmer Jr. is to accompany Oliver Cowdery on a mission to the Lamanites; 9–11, John Whitmer is called to preach the gospel.
Doctrine and Covenants 31	1–6, Thomas B. Marsh is called to preach the gospel and is assured of his family’s well-being; 7–13, He is counseled to be patient, pray always, and follow the Comforter.
Doctrine and Covenants 32	1–3, Parley P. Pratt and Ziba Peterson are called to preach to the Lamanites and to accompany Oliver Cowdery and Peter Whitmer Jr.; 4–5, They are to pray for an understanding of the scriptures.
Doctrine and Covenants 33	1–4, Laborers are called to declare the gospel in the eleventh hour; 5–6, The Church is established, and the elect are to be gathered; 7–10, Repent, for the kingdom of heaven is at hand; 11–15, The Church is built upon the gospel rock; 16–18, Prepare for the coming of the Bridegroom.
Doctrine and Covenants 34	1–4, The faithful become the sons of God through the Atonement; 5–9, The preaching of the gospel prepares the way for the Second Coming; 10–12, Prophecy comes by the power of the Holy Ghost.
Doctrine and Covenants 35	1–2, How men may become the sons of God; 3–7, Sidney Rigdon is called to baptize and to confer the Holy Ghost; 8–12, Signs and miracles are wrought by faith; 13–16, The Lord’s servants will thresh the nations by the power of the Spirit; 17–19, Joseph Smith holds the keys of the mysteries; 20–21, The elect will abide the day of the Lord’s coming; 22–27, Israel will be saved.
Doctrine and Covenants 36	1–3, The Lord lays His hand upon Edward Partridge by the hand of Sidney Rigdon; 4–8, Every man who receives the gospel and the priesthood is to be called to go forth and preach.
Doctrine and Covenants 37	1–4, The Saints are called to gather at the Ohio.
Doctrine and Covenants 38	1–6, Christ created all things; 7–8, He is in the midst of His Saints, who will soon see Him; 9–12, All flesh is corrupted before Him; 13–22, He has reserved a land of promise for His Saints in time and in eternity; 23–27, The Saints are commanded to be one and esteem each other as brethren; 28–29, Wars are predicted; 30–33, The Saints are to be given power from on high and to go forth among all nations; 34–42, The Church is commanded to care for the poor and needy and to seek the riches of eternity.
Doctrine and Covenants 39	1–4, The Saints have power to become the sons of God; 5–6, To receive the gospel is to receive Christ; 7–14, James Covel is commanded to be baptized and labor in the Lord’s vineyard; 15–21, The Lord’s servants are to preach the gospel before the Second Coming; 22–24, Those who receive the gospel will be gathered in time and in eternity.
Doctrine and Covenants 40	1–3, Fear of persecution and cares of the world cause rejection of the gospel.
Doctrine and Covenants 41	1–3, The elders will govern the Church by the spirit of revelation; 4–6, True disciples will receive and keep the Lord’s law; 7–12, Edward Partridge is named as a bishop unto the Church.
Doctrine and Covenants 42	1–10, The elders are called to preach the gospel, baptize converts, and build up the Church; 11–12, They must be called and ordained and are to teach the principles of the gospel found in the scriptures; 13–17, They are to teach and prophesy by the power of the Spirit; 18–29, The Saints are commanded not to kill, steal, lie, lust, commit adultery, or speak evil against others; 30–39, Laws governing the consecration of properties are set forth; 40–42, Pride and idleness are condemned; 43–52, The sick are to be healed through administrations and by faith; 53–60, The scriptures govern the Church and are to be proclaimed to the world; 61–69, The site of the New Jerusalem and the mysteries of the kingdom will be revealed; 70–73, Consecrated properties are to be used to support Church officers; 74–93, Laws governing fornication, adultery, killing, stealing, and confession of sins are set forth.
Doctrine and Covenants 43	1–7, Revelations and commandments come only through the one appointed; 8–14, The Saints are sanctified by acting in all holiness before the Lord; 15–22, Elders are sent forth to cry repentance and prepare men for the great day of the Lord; 23–28, The Lord calls upon men by His own voice and through the forces of nature; 29–35, The Millennium and the binding of Satan will come.
Doctrine and Covenants 44	1–3, Elders are to assemble in conference; 4–6, They are to organize according to the laws of the land and to care for the poor.
Doctrine and Covenants 45	1–5, Christ is our advocate with the Father; 6–10, The gospel is a messenger to prepare the way before the Lord; 11–15, Enoch and his brethren were received by the Lord unto Himself; 16–23, Christ revealed signs of His coming as given on the Mount of Olives; 24–38, The gospel will be restored, the times of the Gentiles will be fulfilled, and a desolating sickness will cover the land; 39–47, Signs, wonders, and the Resurrection are to attend the Second Coming; 48–53, Christ will stand on the Mount of Olives, and the Jews will see the wounds in His hands and feet; 54–59, The Lord will reign during the Millennium; 60–62, The Prophet is instructed to begin the translation of the New Testament, through which important information will be made known; 63–75, The Saints are commanded to gather and build the New Jerusalem, to which people from all nations will come.
Doctrine and Covenants 46	1–2, Elders are to conduct meetings as guided by the Holy Spirit; 3–6, Truth seekers should not be excluded from sacramental services; 7–12, Ask of God and seek the gifts of the Spirit; 13–26, An enumeration of some of these gifts is given; 27–33, Church leaders are given power to discern the gifts of the Spirit.
Doctrine and Covenants 47	1–4, John Whitmer is designated to keep the history of the Church and to write for the Prophet.
Doctrine and Covenants 48	1–3, The Saints in Ohio are to share their lands with their brethren; 4–6, The Saints are to purchase lands, build a city, and follow the counsel of their presiding officers.
Doctrine and Covenants 49	1–7, The day and hour of Christ’s coming will remain unknown until He comes; 8–14, Men must repent, believe the gospel, and obey the ordinances to gain salvation; 15–16, Marriage is ordained of God; 17–21, The eating of meat is approved; 22–28, Zion will flourish and the Lamanites blossom as the rose before the Second Coming.
Doctrine and Covenants 50	1–5, Many false spirits are abroad in the earth; 6–9, Wo unto the hypocrites and those who are cut off from the Church; 10–14, Elders are to preach the gospel by the Spirit; 15–22, Both preachers and hearers need to be enlightened by the Spirit; 23–25, That which doth not edify is not of God; 26–28, The faithful are possessors of all things; 29–36, The prayers of the purified are answered; 37–46, Christ is the Good Shepherd and the Stone of Israel.
Doctrine and Covenants 51	1–8, Edward Partridge is appointed to regulate stewardships and properties; 9–12, The Saints are to deal honestly and receive alike; 13–15, They are to have a bishop’s storehouse and to organize properties according to the Lord’s law; 16–20, Ohio is to be a temporary gathering place.
Doctrine and Covenants 52	1–2, The next conference is designated to be held in Missouri; 3–8, Appointments of certain elders to travel together are made; 9–11, The elders are to teach what the apostles and prophets have written; 12–21, Those enlightened by the Spirit bring forth fruits of praise and wisdom; 22–44, Various elders are appointed to go forth preaching the gospel while traveling to Missouri for the conference.
Doctrine and Covenants 53	1–3, Sidney Gilbert’s calling and election in the Church is to be ordained an elder; 4–7, He is also to serve as a bishop’s agent.
Doctrine and Covenants 54	1–6, The Saints must keep the gospel covenant to gain mercy; 7–10, They must be patient in tribulation.
Doctrine and Covenants 55	1–3, William W. Phelps is called and chosen to be baptized, to be ordained an elder, and to preach the gospel; 4, He is also to write books for children in Church schools; 5–6, He is to travel to Missouri, which will be the area of his labors.
Doctrine and Covenants 56	1–2, The Saints must take up their cross and follow the Lord to gain salvation; 3–13, The Lord commands and revokes, and the disobedient are cast off; 14–17, Wo unto the rich who will not help the poor, and wo unto the poor whose hearts are not broken; 18–20, Blessed are the poor who are pure in heart, for they will inherit the earth.
Doctrine and Covenants 57	1–3, Independence, Missouri, is the place for the City of Zion and the temple; 4–7, The Saints are to purchase lands and receive inheritances in that area; 8–16, Sidney Gilbert is to establish a store, William W. Phelps is to be a printer, and Oliver Cowdery is to edit material for publication.
Doctrine and Covenants 58	1–5, Those who endure tribulation will be crowned with glory; 6–12, The Saints are to prepare for the marriage of the Lamb and the supper of the Lord; 13–18, Bishops are judges in Israel; 19–23, The Saints are to obey the laws of the land; 24–29, Men should use their agency to do good; 30–33, The Lord commands and revokes; 34–43, To repent, men must confess and forsake their sins; 44–58, The Saints are to purchase their inheritance and gather in Missouri; 59–65, The gospel must be preached unto every creature.
Doctrine and Covenants 59	1–4, The faithful Saints in Zion will be blessed; 5–8, They are to love and serve the Lord and keep His commandments; 9–19, By keeping the Lord’s day holy, the Saints are blessed temporally and spiritually; 20–24, The righteous are promised peace in this world and eternal life in the world to come.
Doctrine and Covenants 60	1–9, The elders are to preach the gospel in the congregations of the wicked; 10–14, They should not idle away their time, nor bury their talents; 15–17, They may wash their feet as a testimony against those who reject the gospel.
Doctrine and Covenants 61	1–12, The Lord has decreed many destructions upon the waters; 13–22, The waters were cursed by John, and the destroyer rides upon their face; 23–29, Some have power to command the waters; 30–35, Elders are to journey two by two and preach the gospel; 36–39, They are to prepare for the coming of the Son of Man.
Doctrine and Covenants 62	1–3, Testimonies are recorded in heaven; 4–9, The elders are to travel and preach according to judgment and as directed by the Spirit.
Doctrine and Covenants 63	1–6, A day of wrath will come upon the wicked; 7–12, Signs come by faith; 13–19, The adulterous in heart will deny the faith and be cast into the lake of fire; 20, The faithful will receive an inheritance upon the transfigured earth; 21, A full account of the events on the Mount of Transfiguration has not yet been revealed; 22–23, The obedient receive the mysteries of the kingdom; 24–31, Inheritances in Zion are to be purchased; 32–35, The Lord decrees wars, and the wicked slay the wicked; 36–48, The Saints are to gather to Zion and provide moneys to build it up; 49–54, Blessings are assured the faithful at the Second Coming, in the Resurrection, and during the Millennium; 55–58, This is a day of warning; 59–66, The Lord’s name is taken in vain by those who use it without authority.
Doctrine and Covenants 64	1–11, The Saints are commanded to forgive one another, lest there remain in them the greater sin; 12–22, The unrepentant are to be brought before the Church; 23–25, He that is tithed will not be burned at the Lord’s coming; 26–32, The Saints are warned against debt; 33–36, The rebellious will be cut off out of Zion; 37–40, The Church will judge the nations; 41–43, Zion will flourish.
Doctrine and Covenants 65	1–2, The keys of the kingdom of God are committed to man on earth, and the gospel cause will triumph; 3–6, The millennial kingdom of heaven will come and join the kingdom of God on earth.
Doctrine and Covenants 66	1–4, The everlasting covenant is the fulness of the gospel; 5–8, Elders are to preach, testify, and reason with the people; 9–13, Faithful ministerial service ensures an inheritance of eternal life.
Doctrine and Covenants 67	1–3, The Lord hears the prayers of and watches over His elders; 4–9, He challenges the wisest person to duplicate the least of His revelations; 10–14, Faithful elders will be quickened by the Spirit and see the face of God.
Doctrine and Covenants 68	1–5, The words of the elders when moved upon by the Holy Ghost are scripture; 6–12, Elders are to preach and baptize, and signs will follow true believers; 13–24, The firstborn among the sons of Aaron may serve as the Presiding Bishop (that is, hold the keys of presidency as a bishop) under the direction of the First Presidency; 25–28, Parents are commanded to teach the gospel to their children; 29–35, The Saints are to observe the Sabbath, labor diligently, and pray.
Doctrine and Covenants 69	1–2, John Whitmer is to accompany Oliver Cowdery to Missouri; 3–8, He is also to preach and to collect, record, and write historical data.
Doctrine and Covenants 70	1–5, Stewards are appointed to publish the revelations; 6–13, Those who labor in spiritual things are worthy of their hire; 14–18, The Saints should be equal in temporal things.
Doctrine and Covenants 71	1–4, Joseph Smith and Sidney Rigdon are sent forth to proclaim the gospel; 5–11, Enemies of the Saints will be confounded.
Doctrine and Covenants 72	1–8, Elders are to render an account of their stewardship unto the bishop; 9–15, The bishop keeps the storehouse and cares for the poor and needy; 16–26, Bishops are to certify the worthiness of elders.
Doctrine and Covenants 73	1–2, Elders are to continue to preach; 3–6, Joseph Smith and Sidney Rigdon are to continue to translate the Bible until it is finished.
Doctrine and Covenants 74	1–5, Paul counsels the Church of his day not to keep the law of Moses; 6–7, Little children are holy and are sanctified through the Atonement.
Doctrine and Covenants 75	1–5, Faithful elders who preach the gospel will gain eternal life; 6–12, Pray to receive the Comforter, who teaches all things; 13–22, Elders will sit in judgment on those who reject their message; 23–36, Families of missionaries are to receive help from the Church.
Doctrine and Covenants 76	1–4, The Lord is God; 5–10, The mysteries of the kingdom will be revealed to all the faithful; 11–17, All will come forth in the resurrection of the just or the unjust; 18–24, The inhabitants of many worlds are begotten sons and daughters unto God through the Atonement of Jesus Christ; 25–29, An angel of God fell and became the devil; 30–49, Sons of perdition suffer eternal damnation; all others gain some degree of salvation; 50–70, The glory and reward of exalted beings in the celestial kingdom is described; 71–80, Those who will inherit the terrestrial kingdom are described; 81–113, The status of those in the telestial, terrestrial, and celestial glories is explained; 114–19, The faithful may see and understand the mysteries of God’s kingdom by the power of the Holy Spirit.
Doctrine and Covenants 77	1–4, Beasts have spirits and will dwell in eternal felicity; 5–7, This earth has a temporal existence of 7,000 years; 8–10, Various angels restore the gospel and minister on earth; 11, The sealing of the 144,000; 12–14, Christ will come in the beginning of the seventh thousand years; 15, Two prophets will be raised up to the Jewish nation.
Doctrine and Covenants 78	1–4, The Saints should organize and establish a storehouse; 5–12, Wise use of their properties will lead to salvation; 13–14, The Church should be independent of earthly powers; 15–16, Michael (Adam) serves under the direction of the Holy One (Christ); 17–22, Blessed are the faithful, for they will inherit all things.
Doctrine and Covenants 79	1–4, Jared Carter is called to preach the gospel by the Comforter.
Doctrine and Covenants 80	1–5, Stephen Burnett and Eden Smith are called to preach in whatever place they choose.
Doctrine and Covenants 81	1–2, The keys of the kingdom are always held by the First Presidency; 3–7, If Frederick G. Williams is faithful in his ministry, he will have eternal life.
Doctrine and Covenants 82	1–4, Where much is given, much is required; 5–7, Darkness reigns in the world; 8–13, The Lord is bound when we do what He says; 14–18, Zion must increase in beauty and holiness; 19–24, Every man should seek the interest of his neighbor.
Doctrine and Covenants 83	1–4, Women and children have claim upon their husbands and fathers for their support; 5–6, Widows and orphans have claim upon the Church for their support.
Doctrine and Covenants 84	1–5, The New Jerusalem and the temple will be built in Missouri; 6–17, The line of priesthood from Moses to Adam is given; 18–25, The greater priesthood holds the key of the knowledge of God; 26–32, The lesser priesthood holds the key of the ministering of angels and of the preparatory gospel; 33–44, Men gain eternal life through the oath and covenant of the priesthood; 45–53, The Spirit of Christ enlightens men, and the world lies in sin; 54–61, The Saints must testify of those things they have received; 62–76, They are to preach the gospel, and signs will follow; 77–91, Elders are to go forth without purse or scrip, and the Lord will care for their needs; 92–97, Plagues and cursings await those who reject the gospel; 98–102, The new song of the redemption of Zion is given; 103–10, Let every man stand in his own office and labor in his own calling; 111–20, The Lord’s servants are to proclaim the abomination of desolation of the last days.
Doctrine and Covenants 85	1–5, Inheritances in Zion are to be received through consecration; 6–12, One mighty and strong will give the Saints their inheritance in Zion.
Doctrine and Covenants 86	1–7, The Lord gives the meaning of the parable of the wheat and tares; 8–11, He explains priesthood blessings to those who are lawful heirs according to the flesh.
Doctrine and Covenants 87	1–4, War is foretold between the Northern States and the Southern States; 5–8, Great calamities will fall upon all the inhabitants of the earth.
Doctrine and Covenants 88	1–5, Faithful Saints receive that Comforter, which is the promise of eternal life; 6–13, All things are controlled and governed by the Light of Christ; 14–16, The Resurrection comes through the Redemption; 17–31, Obedience to celestial, terrestrial, or telestial law prepares men for those respective kingdoms and glories; 32–35, Those who will to abide in sin remain filthy still; 36–41, All kingdoms are governed by law; 42–45, God has given a law unto all things; 46–50, Man will comprehend even God; 51–61, The parable of the man sending his servants into the field and visiting them in turn; 62–73, Draw near unto the Lord, and ye will see His face; 74–80, Sanctify yourselves and teach one another the doctrines of the kingdom; 81–85, Every man who has been warned should warn his neighbor; 86–94, Signs, upheavals of the elements, and angels prepare the way for the coming of the Lord; 95–102, Angelic trumps call forth the dead in their order; 103–16, Angelic trumps proclaim the restoration of the gospel, the fall of Babylon, and the battle of the great God; 117–26, Seek learning, establish a house of God (a temple), and clothe yourselves with the bond of charity; 127–41, The order of the School of the Prophets is set forth, including the ordinance of washing of feet.
Doctrine and Covenants 89	1–9, The use of wine, strong drinks, tobacco, and hot drinks is proscribed; 10–17, Herbs, fruits, flesh, and grain are ordained for the use of man and of animals; 18–21, Obedience to gospel law, including the Word of Wisdom, brings temporal and spiritual blessings.
Doctrine and Covenants 90	1–5, The keys of the kingdom are committed to Joseph Smith and through him to the Church; 6–7, Sidney Rigdon and Frederick G. Williams are to serve in the First Presidency; 8–11, The gospel is to be preached to the nations of Israel, to the Gentiles, and to the Jews, every man hearing in his own tongue; 12–18, Joseph Smith and his counselors are to set the Church in order; 19–37, Various individuals are counseled by the Lord to walk uprightly and serve in His kingdom.
Doctrine and Covenants 91	1–3, The Apocrypha is mostly translated correctly but contains many interpolations by the hands of men that are not true; 4–6, It benefits those enlightened by the Spirit.
Doctrine and Covenants 92	1–2, The Lord gives a commandment relative to admission to the united order.
Doctrine and Covenants 93	1–5, All who are faithful will see the Lord; 6–18, John bore record that the Son of God went from grace to grace until He received a fulness of the glory of the Father; 19–20, Faithful men, going from grace to grace, will also receive of His fulness; 21–22, Those who are begotten through Christ are the Church of the Firstborn; 23–28, Christ received a fulness of all truth, and man by obedience may do likewise; 29–32, Man was in the beginning with God; 33–35, The elements are eternal, and man may receive a fulness of joy in the Resurrection; 36–37, The glory of God is intelligence; 38–40, Children are innocent before God because of the redemption of Christ; 41–53, The leading brethren are commanded to set their families in order.
Doctrine and Covenants 94	1–9, The Lord gives a commandment relative to the erection of a house for the work of the Presidency; 10–12, A printing house is to be built; 13–17, Certain inheritances are assigned.
Doctrine and Covenants 95	1–6, The Saints are chastened for their failure to build the house of the Lord; 7–10, The Lord desires to use His house to endow His people with power from on high; 11–17, The house is to be dedicated as a place of worship and for the school of the Apostles.
Doctrine and Covenants 96	1, The Kirtland Stake of Zion is to be made strong; 2–5, The bishop is to divide the inheritances for the Saints; 6–9, John Johnson is to be a member of the united order.
Doctrine and Covenants 97	1–2, Many of the Saints in Zion (Jackson County, Missouri) are blessed for their faithfulness; 3–5, Parley P. Pratt is commended for his labors in the school in Zion; 6–9, Those who observe their covenants are accepted by the Lord; 10–17, A house is to be built in Zion in which the pure in heart will see God; 18–21, Zion is the pure in heart; 22–28, Zion will escape the Lord’s scourge if she is faithful.
Doctrine and Covenants 98	1–3, The afflictions of the Saints will be for their good; 4–8, The Saints are to befriend the constitutional law of the land; 9–10, Honest, wise, and good men should be supported for secular government; 11–15, Those who lay down their lives in the Lord’s cause will have eternal life; 16–18, Renounce war and proclaim peace; 19–22, The Saints in Kirtland are reproved and commanded to repent; 23–32, The Lord reveals His laws governing the persecutions and afflictions imposed on His people; 33–38, War is justified only when the Lord commands it; 39–48, The Saints are to forgive their enemies, who, if they repent, will also escape the Lord’s vengeance.
Doctrine and Covenants 99	1–8, John Murdock is called to proclaim the gospel, and those who receive him receive the Lord and will obtain mercy.
Doctrine and Covenants 100	1–4, Joseph and Sidney to preach the gospel for the salvation of souls; 5–8, It will be given them in the very hour what they should say; 9–12, Sidney is to be a spokesman and Joseph is to be a revelator and mighty in testimony; 13–17, The Lord will raise up a pure people, and the obedient will be saved.
Doctrine and Covenants 101	1–8, The Saints are chastened and afflicted because of their transgressions; 9–15, The Lord’s indignation will fall upon the nations, but His people will be gathered and comforted; 16–21, Zion and her stakes will be established; 22–31, The nature of life during the Millennium is set forth; 32–42, The Saints will be blessed and rewarded then; 43–62, The parable of the nobleman and the olive trees signifies the troubles and eventual redemption of Zion; 63–75, The Saints are to continue gathering together; 76–80, The Lord established the Constitution of the United States; 81–101, The Saints are to importune for the redress of grievances, according to the parable of the woman and the unjust judge.
Doctrine and Covenants 102	1–8, A high council is appointed to settle important difficulties that arise in the Church; 9–18, Procedures are given for hearing cases; 19–23, The president of the council renders the decision; 24–34, Appellate procedure is set forth.
Doctrine and Covenants 103	1–4, Why the Lord permitted the Saints in Jackson County to be persecuted; 5–10, The Saints will prevail if they keep the commandments; 11–20, The redemption of Zion will come by power, and the Lord will go before His people; 21–28, The Saints are to gather in Zion, and those who lay down their lives will find them again; 29–40, Various brethren are called to organize Zion’s Camp and go to Zion; they are promised victory if they are faithful.
Doctrine and Covenants 104	1–10, Saints who transgress against the united order will be cursed; 11–16, The Lord provides for His Saints in His own way; 17–18, Gospel law governs the care of the poor; 19–46, The stewardships and blessings of various brethren are designated; 47–53, The united order in Kirtland and the order in Zion are to operate separately; 54–66, The sacred treasury of the Lord is set up for the printing of the scriptures; 67–77, The general treasury of the united order is to operate on the basis of common consent; 78–86, Those in the united order are to pay all their debts, and the Lord will deliver them from financial bondage.
Doctrine and Covenants 105	1–5, Zion will be built up by conformity to celestial law; 6–13, The redemption of Zion is deferred for a little season; 14–19, The Lord will fight the battles of Zion; 20–26, The Saints are to be wise and not boast of mighty works as they gather; 27–30, Lands in Jackson and adjoining counties should be purchased; 31–34, The elders are to receive an endowment in the house of the Lord in Kirtland; 35–37, Saints who are both called and chosen will be sanctified; 38–41, The Saints are to lift an ensign of peace to the world.
Doctrine and Covenants 106	1–3, Warren A. Cowdery is called as a local presiding officer; 4–5, The Second Coming will not overtake the children of light as a thief; 6–8, Great blessings follow faithful service in the Church.
Doctrine and Covenants 107	1–6, There are two priesthoods: the Melchizedek and the Aaronic; 7–12, Those who hold the Melchizedek Priesthood have power to officiate in all offices in the Church; 13–17, The bishopric presides over the Aaronic Priesthood, which administers in outward ordinances; 18–20, The Melchizedek Priesthood holds the keys of all spiritual blessings; the Aaronic Priesthood holds the keys of the ministering of angels; 21–38, The First Presidency, the Twelve, and the Seventy constitute the presiding quorums, whose decisions are to be made in unity and righteousness; 39–52, The patriarchal order is established from Adam to Noah; 53–57, Ancient Saints assembled at Adam-ondi-Ahman, and the Lord appeared to them; 58–67, The Twelve are to set the officers of the Church in order; 68–76, Bishops serve as common judges in Israel; 77–84, The First Presidency and the Twelve constitute the highest court in the Church; 85–100, Priesthood presidents govern their respective quorums.
Doctrine and Covenants 108	1–3, Lyman Sherman forgiven of his sins; 4–5, He is to be numbered with the leading elders of the Church; 6–8, He is called to preach the gospel and strengthen his brethren.
Doctrine and Covenants 109	1–5, The Kirtland Temple was built as a place for the Son of Man to visit; 6–21, It is to be a house of prayer, fasting, faith, learning, glory, and order, and a house of God; 22–33, May the unrepentant who oppose the Lord’s people be confounded; 34–42, May the Saints go forth in power to gather the righteous to Zion; 43–53, May the Saints be delivered from the terrible things to be poured out upon the wicked in the last days; 54–58, May nations and peoples and churches be prepared for the gospel; 59–67, May the Jews, the Lamanites, and all Israel be redeemed; 68–80, May the Saints be crowned with glory and honor and gain eternal salvation.
Doctrine and Covenants 110	1–10, The Lord Jehovah appears in glory and accepts the Kirtland Temple as His house; 11–12, Moses and Elias each appear and commit their keys and dispensations; 13–16, Elijah returns and commits the keys of his dispensation as promised by Malachi.
Doctrine and Covenants 111	1–5, The Lord looks to the temporal needs of His servants; 6–11, He will deal mercifully with Zion and arrange all things for the good of His servants.
Doctrine and Covenants 112	1–10, The Twelve are to send the gospel and raise the warning voice to all nations and people; 11–15, They are to take up their cross, follow Jesus, and feed His sheep; 16–20, Those who receive the First Presidency receive the Lord; 21–29, Darkness covers the earth, and only those who believe and are baptized will be saved; 30–34, The First Presidency and the Twelve hold the keys of the dispensation of the fulness of times.
Doctrine and Covenants 113	1–6, The Stem of Jesse, the rod coming therefrom, and the root of Jesse are identified; 7–10, The scattered remnants of Zion have a right to the priesthood and are called to return to the Lord.
Doctrine and Covenants 114	1–2, Church positions held by those who are not faithful will be given to others.
Doctrine and Covenants 115	1–4, The Lord names His church The Church of Jesus Christ of Latter-day Saints; 5–6, Zion and her stakes are places of defense and refuge for the Saints; 7–16, The Saints are commanded to build a house of the Lord at Far West; 17–19, Joseph Smith holds the keys of the kingdom of God on earth.
